#domain
hospital
#levelname
BFSfriendly
#colors
blue: 0,1,2
#initial
+++++++++++
+         +
+         +
+         +
+         +
+         +
+         +
+         +
+  0 1 2  +
+ + + + + +
+++++++++++
#goal
+++++++++++
+         +
+         +
+         +
+         +
+         +
+         +
+         +
+         +
+ +0+1+2+ +
+++++++++++
#end
